               ###########################
               #                         #
               #                         #
               #                         #
              #          #######        #
              #          #     #        #
              #          #     #        #
              #          #     #        #
              #          #     #        #
              #          #######        #
               #                         #
################                         #
#               #                        #
#               #####                    #
#                                        #
#                ####                    #
#                #                       #
#                #                       #
####################################     #