############################              
#                          #              
#                          #              
#                          #              
 #         ########         #              
 #         #      #         #              
 #         #      #         #              
 #         #      #         #              
 #         #      #         #              
 #         ########         #              
#                          #              
#                         ################
#                         #              #
#                     #####              #
#                                        #
#                     ####               #
#                        #               #
#                        #               #
##########################           #####