####################################     #
#                                        #
#                                        #
                                         #
                                         #
                                         #
                                         #
#                                        #
#                                        #
#                                        #
#                                        #
#          #######################   #####
###########                #             #
#         #                #             #
#         #                #             #
          #                #             #
#         #                #             #
#         #                              #
##########################################