##########################           #####
#                   #                    #
#                   #                    #
#                                         
#                                         
#                                         
#                                         
#                   #                    #
#                   #                    #
#######     ##################           #
#                   #        #           #
#                   #                    #
#                   #        #           #
#                   #        #############
#                   #                    #
#                   #                    #
#                   #                    #
#                   #                    #
##########################################